111111111111111111111111111111111111111111111111111111111111111111111111111111111111111111111
100C000000000000000000000000000CCC00000000000000000000000000CC0000000000000M00000000000000001
100000000111111111111111111100000000000000000000000000000000000000000000000000000000000111111
1000000000P000000000000000000000CCC000000000000000111111111111111111110000000000000M000000001
11111100000000M000000000000000000000000000000000M0000000000000000000CCCCCCCCCCC00000000000001
1000000000000000000C0000CCCCCC0000000000C0000000000000000000000000000000000CCCCCCCCC000000001
100001111111111111111100000000000000000000000000000000000000000000000000000000000000000000001
1000000M000000000000000000000000000000CCCCCCCCCCC00000000000000011111111111111111111111111001
100000000000000001111100000000000M00000000000000000000000000000000E00000001111100000000011111
111111000000CCCCCCCCCCCC00000000000000000000000000M0000000000000000000000000000CCCCCC00000001
100000000000000000111111111111111111110000000000000000011111111111111111111111100000000000001
1000000CCCCCCCC00000000000000000000000M000000000000M00000000000000000CCCCCCCCCCC0000000000001
111111111111111111111111111111111111111111111111111111111111111111111111111111111111111111111